0,M1,0,M2,G
M3,0,0,I,0,
0,I,M4,0,M5
0,M6,0,M7,0
S,M8,0,0,M9